R 2880 1620

NO textures/WALL75.xpm
SO textures/WALL64.xpm
WE textures/grey.xpm
EA textures/WALL3.xpm
S  textures/chest.xpm

F 220,100,0
C 225,30,0

    11111111111111111111111111
    10000000001100222222222001
    101100W0011100000000000001
    10010000000000000000000001
111111111011000001110000110001
1000000000110000011101111000011
111101111111110111000000100001
111101111111110111010100100001
110000001101010111000000100001
10002000 0 0 0 011000000100001
100000000000000011010100000001
11000001110101011111011110000111
111101111111010   011110100001
111111111111111111111111111111