R 2560 1440

NO textures/WALL75.xpm
SO textures/WALL64.xpm
WE textures/grey.xpm
EA textures/WALL3.xpm
S  textures/chest.xpm

F 220,100,0
C 225,30,0

111111111111111
100000000000001
100000000000001
100000000000001
1000000S0000001
100000000000001
100000000000001
120000000000001
100000000000001
111111111111111